AAAAAAARRRRR
AARRRAAAAAAR
AAEESAAAAAAA
EENASAAAESAA
AAAASAEENEEE
AASWWANAAAAA
AASRRANAAAAA
AASAAANAAAAA
AAEEEENAAAAR
AAAAAAAAAAAR
AAAARRAAAARR
AAAAAAAARRRR
#12120104