AAAAAAARRRR
AARRRAAAAAA
AAEESAAAAAA
EENASAAAESA
AAAASAEENEE
AASWWANAAAA
AASRRANAAAA
AASAAANAAAA
AAEEEENAAAA
AAAAAAAAAAA
AAAAAAAAAAA
#11110104