RAASAAAARRRR
AAASAAAAARRR
AAASRAAAAAAR
AAAEESRAAAAR
ARRAASAAAARR
AASWWWAAAAAR
AASAEESAAAAA
AAEENASAAAAA
AAAAAASAAAAA
AAAAAASAAAAA
#12100401