RRRRRRRRRRRRRRRR
RRAAAAAAAAARRRRR
RAAARRRAAAAAAARR
AAAAASWWWWWAAAAA
RAAAASAAAANAAAAA
RAAAASAAEENAAAAA
ASWWAESANAAAAAAA
RSRNAASANAASWWWW
RSANWWWANAASAAAA
ASRAAAAANWWWAAAR
ASAAAAAAAAAAARRR
#16111608